NO assets/mossy.xpm
SO assets/bluestone.xpm
WE assets/purplestone.xpm
EA assets/eagle.xpm

F 128,45,62
C 42,43,153

FT assets/gold.xp
CT assets/wood.xpm

11111111111111111111111111111
100000000000000000000000000011
10000000000N0000000000000000001
10000000001010000000000000000001
100000000100010000000000000000001
1000000010000010000000000000000001
10000001000000010000000000000000001
100000100000000010000000000000000001
1000010000000000011000000000000000001
10001000000000000000000000000000000001
100100000000000000000000000000000000001
11111111111111111111111111111111111111
