NO assets/mossy.xpm
SO assets/bluestone.xpm
WE assets/purplestone.xpm
EA assets/eagle.xpm

F 128,45,62
C 42,43,255

FT assets/dirt.xpm
CT assets/cobble.xpm

11111111111111111111111111111
1000000000000000000000000000111
 10000000000000000000000000000011
  10000000000N000000000000000000011
   1000000000000000000000000000000011
    1000000000000001110100000000000001
    1000000000000001   1000000000000001
1111100000000000000111110000000000000011
10000100000000000000000000000000000111
10001000000000000000000000000000000001
100100000000000000000000000000000000001
11111111111111111111111111111111111111
